SCENE = {
	SHOP = "scene shop",
	COLLECTSHIP = "scene collect ship",
	BIANDUI = "scene biandui",
	DEPOTSCENE = "scene depot scene",
	COMMANDERINFO = "scene commander info",
	CHUANWU = "scene shipyard",
	EQUIPDEV = "scene equip dev",
	COMBATLOAD = "scene combat load",
	RESOLVEEQUIP = "scene resolve equip",
	TRANSITION = "scene transition",
	COLORING = "scene coloring",
	NEWGUILD = "scene newguild",
	COMMANDPOST = "scene command post",
	PLAYER_INFO = "scene player info",
	SETTINGS = "scene settings",
	DOCKYARD = "scene dockyard",
	CHUZHENG = "scene chuzheng",
	GETBOAT = "scene get boat",
	UPGRADESTAR = "scene upgrade star",
	CLASS = "scene class",
	NAVALACADEMYSCENE = "naval academy scene",
	GUILD = "scene guild",
	CHARGE = "scene charge",
	BILLBOARD = "scene billboard",
	TASK = "scene task",
	LEVEL = "scene level",
	EXERCISEFORMATION = "scene exerciseformaion",
	CREATE_PLAYER = "scene create player",
	SNAPSHOT = "snapshot",
	ANSWER = "answer",
	TECHNOLOGY = "technology",
	SELTECHNOLOGY = "seltechnology",
	DAILYLEVEL = "scene dailylevel",
	SHIPBLUEPRINT = "shipblueprint",
	SHIP_PROFILE = "ship profile",
	ANNIVERSARY = "anniversary",
	SUMMARY = "summary",
	RESOLVESHIPS = "scene resolve ships",
	CARD_PAIRS = "card pairs",
	EQUIPSCENE = "scene equip",
	EQUIPSYNTHESIS = "scene equip synthesis",
	SHIPINFO = "scene shipinfo",
	EVENT = "scene event",
	FRIEND = "scene friend",
	BATTLE = "scene battle",
	PROPINFO = "scene prop info",
	VOTE = "scene vote",
	LOGIN = "scene login",
	MAINUI = "scene mainUI",
	ACTIVITY = "scene activity",
	MILITARYEXERCISE = " scene militaryexercise",
	BACKYARD = "scene back yard"
}

return
